███████████████████████
██████████V████████████
██████████ ████████████
█████████   ████████F██
█████████ █ ████████ ██ 
█████████   ████████ ██
███        █████████ ██
███ ████ ███████████ ██
█         █          ██
█ ███████ █ ████ ██████
█         █ ████ ██████
█ █████ ███  E        █
█ █████ █████ ███████ █
█   Y     ███         █
█████████ ███ █████████
█         ███ █████████
█ ███████████ █████████
█ ██                  █ 
█ ██ ████████ ███████ █
█ ██    W             █
█ ███████████████████ █ 
█                     █
██████████ ███ █████  █
██████████     ████████
███████████████████████